Welcome to your journey, Axesto! You are going to leave your home planet Fidatis for the first time. Isn't it exciting? Finally, you can expercience everything by yourself. Although you love your home - the wide lush meadows, the different colourful flowers, the clear small seas and especially your family. But it's about time. You are full-aged now, so you are allowed to leave Fidatis for the first time. And not for anything in the world you would miss this chance. You already know what your first goal will be - the only planet you have been able to see since you are alive. You neither know its name nor anything else... but you know that you've always wanted to travel there. The engine starts, you focuse your view, the spaceship raises - your journey begins.

 Remember that you can always type "helper" in order to get a list of helpful commands. Above the images you will see a map to help you orientate yourself, the star marks your position. For other information please take a look in the ReadMe file attached to this game.

CHAPTER 1- SITIS

On the Lookout
A Space Quest by Daniel, Tim, Franziska, Kevin, Tobias
Release 1 / Serial number 170807 / Inform 7 build 6M62 (I6/v6.33 lib 6/12N) SD

Your arrival point: The Flat Rock
You arrive on a planet called Sitis. You think the landing went flawlessly but as you leave your spaceship, you realise that two of your three water containers broke down. Without at least one new watertank you can not continue your journey. Far away in the east you recognise shapes like rooftops. Maybe someone is living there who could help you?

>teleport to kaldrís
I didn't understand that sentence.

>teleport to kaldríss
Spaceship Bridge
The place where all the magic happens. Well, it used to be at least - during the impact most of the important equpiment, including the communication systems, must have been fried and doesn't seem to work anymore.

There's only a single flickering light inside the command panel.

What could this mean? I should probably open the command panel and take a look. I could also go south and check the storage of the spaceship first.

You can see a command panel (closed) here.

>open panel
You manage to remove the protective layer of the command panel revealing the mainframe with all the important stuff.  Usually it's not advised to do this by yourself but tough times call for tough measures. Now you're also able to examine the command panel a little further and see what's inside.

>x panel
Your trustworthy command panel.

In the command panel are a protector glove, a communicator, a power reserve, a green button and an encryption key.

>unlock panel
(with the backpack)
That doesn't seem to be something you can unlock.

>take all
protector glove: Taken.
encryption key: Taken.

>push button
Beep Boop! Power Reserve status: UNLOCKED.

This power reserve is used to store highly volatile energy currents. Proceed with caution.

>wear glove
You put on the protector glove.

>open reserve
You open the power reserve, revealing a flux essence fragment.

>take all
flux essence fragment: This glove truly works wonders. No harm done.

>s
Spaceship Storage
Taking a quick look inside the storage room doesn't seem to reveal anything particularly interesting. There are only some random souvenirs from your previous intergalactic travels but also your locker which possibly contains things you could really use in this kind of situation. Oh, and the suit chamber of course. It also looks like the airlock in the south doesn't seem to function anymore so perhaps you should go check that out as well?

You can see a locker (closed) and a suit chamber (closed) here.

>open chamber
Seal Status: DEACTIVATED //

Contamination Level Check: 0,00 %

Opening chamber.

Spacesuit can now be taken out safely.

>take all
spacesuit: 

Taken.

Spacesuit Mk. XV

Made for deep space travel due to its extraordinary thermodynamic capabilities.

This model also has an energy capacitor built in that needs some kind of energy in order to properly work. The more pure the energy the more effective the suits thermal protection will work.

Suit Thermal Protection Systems S.T.P.S. Status: OFFLINE //

Awaiting insertion of power source into energy capacitor ---

>s
Spaceship Exit
The airlock also seems to be affected by the crash and the temperatures inside the spaceship are nearing dangerous levels. You could leave the spaceship right now by going east but I if you don't have something to protect yourself from the cold you will probably die.

>e
You can't leave the spaceship just yet. You need to find something to keep you warm before you venture off!

>wear suit
You can't see any such thing.

>put essence into suit
You can't see any such thing.

>put essence into capacitor
Do I really wanna do this? Chances of me dying are quite high. On the other hand, I will probably die anyway. Careful now. And ..

oh no ..

NONONO

WAIT .. EUREKA .. it actually worked!

>e
You can't leave the spaceship just yet. You need to find something to keep you warm before you venture off!

>i
You are carrying:
  a spacesuit
  an encryption key
  a protector glove (being worn)
  a backpack (being worn)

>wear spacesuit
You put on the spacesuit.

>e
You can't leave the spaceship just yet. You need to find something to keep you warm before you venture off!

>n
Spaceship Storage
Taking a quick look inside the storage room doesn't seem to reveal anything particularly interesting. There are only some random souvenirs from your previous intergalactic travels but also your locker which possibly contains things you could really use in this kind of situation. Oh, and the suit chamber of course. It also looks like the airlock in the south doesn't seem to function anymore so perhaps you should go check that out as well?

You can see a locker (closed) and a suit chamber (empty) here.

>unlock locker
What do you want to unlock the locker with?

>unlock locker with key
This key seems to fit.  Lock mechanism status: DEACTIVATED // You may proceed to open the locker.

>take all
There are none at all available!

>open locker
You open the locker, revealing an emergency torch.

>take torch
This baby will light up no matter how harsh the conditions are since it uses a special fuel for the ignition process. However, I doubt that this will be enough to let me wander around on the surface of Kaldríss.

>n
Spaceship Bridge
The place where all the magic happens. Well, it used to be at least - during the impact most of the important equpiment, including the communication systems, must have been fried and doesn't seem to work anymore.

There's only a single flickering light inside the command panel.

What could this mean? I should probably open the command panel and take a look. I could also go south and check the storage of the spaceship first.

You can see a command panel (in which are a communicator, a power reserve (empty) and a green button) here.

>e
You don't want to run into one of the walls of your spaceship, do you?

>s
Spaceship Storage
Taking a quick look inside the storage room doesn't seem to reveal anything particularly interesting. There are only some random souvenirs from your previous intergalactic travels but also your locker which possibly contains things you could really use in this kind of situation. Oh, and the suit chamber of course. It also looks like the airlock in the south doesn't seem to function anymore so perhaps you should go check that out as well?

You can see a locker (empty) and a suit chamber (empty) here.

>e
There's only two directions you can go. Either south to the back of the ship or north to the bridge.

>s
Spaceship Exit
The airlock also seems to be affected by the crash and the temperatures inside the spaceship are nearing dangerous levels. You could leave the spaceship right now by going east but I if you don't have something to protect yourself from the cold you will probably die.

>e
Now that you found a way to stay warm you should be able to leave the spaceship without instantly freezing to death.

Crash Zone
The surface of Kaldríss consists of spiky ice formations as far as the eye can see . No wonder nobody in his right mind would try to land here willingly. There doesn't seem to be anything of interest wherever you look. After taking a closer look you suddenly notice some sort of structure north of your position. If you hurry up you should be able to make it there before you freeze.

>e
Seems like there is some kind of blizzard going on in this direction. It's absolutely not advised going there since you would probably die.

>n
You walk towards that structure you saw earlier. You're getting closer and closer.

Then you realize what exactly it is you are walking towards. Suddenly you have this tiny glimmer of hope inside you.

Hunting Grounds
Turns out this used to be an explorer camp and you instantly feel a little less lonely and also more safe. Seems like a good place to stay for a while and try not to freeze to death. But where did those explorers go and why did they leave pretty much everything behind? Further investigations of this place also reveal something resembling a huge hole in the ground.

You make your way to said hole and realize it could be a cave entrance. The only problem is that there is a massive stone plate blocking the entrance.

You can see a stone plate here.

>d
You can't possibly enter whatever it is that lies behind this stone plate before you've shoved it aside!

>shove plate aside
You manage to shove the stone plate ot ouf the way thus enabling you to finally go down and descend into this extremely dark and tight hole. Let's just hope nothing bad happens and that temperatures down there are a little higher than on the surface.

>d
You are finally able to enter the cave but you should still proceed with caution since you never know what's waiting inside.

Cave Entrance
Since there is only a tiny amount of light in this cave it's hard to make out it's size and where to go.  Judging from the acoustics  though it seems as this is only one of many caves that are all part of some kind of underground cave system. You can also hear footsteps from time to time but they sound way heavier than the ones of regular human beings.  If you don't know where to go you could just try to follow the footsteps in the same direction. However, you should still be really careful when doing so since it's probably for the best if you stay undetected for now.

You can see a stone plate here.

Yundar arrives from the east.

Yarwol arrives from the east.

>e
You sneakily followed one of the mysterious creatures. Luckily nobody has noticed you. So far so good. Now it's time to find out how you could get out of here. You take a look around this cave and notice these suspicious rocks. You can't help but feel like someone is trying to hide something inside them so probably you should try to very carefully shove them aside and see if you're right.

Small Cave
This cave is way smaller than the previous one. You start to wonder how many of these caves can be found down here. You might end up getting lost and never see daylight again. What if one of those creatures finds you and decides to eat you? I definitely don't want to die by getting eaten by whatever it is that lives down here. You better get going and figure out how to get out of here ASAP.

You can see suspicious rocks (closed) here.

Yundar arrives from the west.

Yarwol arrives from the west.

>s
Looks like this is the cave that connects them all which also explains why it's that much bigger than the ones before.  You can also notice a tiny gap in the east wall. Directly next to it is a small hole in the wall that seems to have a very specific shape. It could be some kind of keyhole. If this assumption is true and this turns out to be a door of some kind then you should probably go there and see for yourself.

Cave Junction
Alright, this is the biggest one yet. It seems to be a junction of some sort. It's not only the biggest cave you've encountered so far but there are also numerous tunnels leading away from it. It would probably interesting to find out where all those tunnels lead but it wouldn't be a smart decision to make in your current situation. You should better search for the nearest exit if there is any.

>e
This door doesn't seem to open without the corresponding keystone. It's probably hidden somewhere in here.

>n
Small Cave
This cave is way smaller than the previous one. You start to wonder how many of these caves can be found down here. You might end up getting lost and never see daylight again. What if one of those creatures finds you and decides to eat you? I definitely don't want to die by getting eaten by whatever it is that lives down here. You better get going and figure out how to get out of here ASAP.

You can see Yarwol, Yundar and suspicious rocks (closed) here.

Yundar goes west.

Yarwol goes west.

>open rocks
You carefully shoved aside the suspicious rocks, revealing Yarwol's Keystone.

Yundar arrives from the west.

Yarwol arrives from the west.

>take all
Yarwol's Keystone: This thing has a very weird shape but you should probably hold on to it for now since you never know when it might prove useful.

Taken.

Yundar goes west.

Yarwol goes west.

>s
Cave Junction
Alright, this is the biggest one yet. It seems to be a junction of some sort. It's not only the biggest cave you've encountered so far but there are also numerous tunnels leading away from it. It would probably interesting to find out where all those tunnels lead but it wouldn't be a smart decision to make in your current situation. You should better search for the nearest exit if there is any.

>e
Secret Cave
Who would've thought that there's a hidden cave in here? Apparently only a few selected creatures know of its existence. The rest of them are in the dark about it.

Hah

Anyway, there's a huge light beam in the middle of the cave that seems to able to transport you up to another place. How exactly this even works and where exactly this place might be is rather unimportant at the moment. Any place is better than this one. At least that's what you keep telling yourself.

>w
Cave Junction
Alright, this is the biggest one yet. It seems to be a junction of some sort. It's not only the biggest cave you've encountered so far but there are also numerous tunnels leading away from it. It would probably interesting to find out where all those tunnels lead but it wouldn't be a smart decision to make in your current situation. You should better search for the nearest exit if there is any.

You can see Yarwol and Yundar here.

Grrhrhhrhrhrhrhrrrrhhhrghr
Grmmmppfpprrpprrrffffr

>n
Small Cave
This cave is way smaller than the previous one. You start to wonder how many of these caves can be found down here. You might end up getting lost and never see daylight again. What if one of those creatures finds you and decides to eat you? I definitely don't want to die by getting eaten by whatever it is that lives down here. You better get going and figure out how to get out of here ASAP.

You can see suspicious rocks (empty) here.

Yarwol arrives from the south.

>w
Cave Entrance
Since there is only a tiny amount of light in this cave it's hard to make out it's size and where to go.  Judging from the acoustics  though it seems as this is only one of many caves that are all part of some kind of underground cave system. You can also hear footsteps from time to time but they sound way heavier than the ones of regular human beings.  If you don't know where to go you could just try to follow the footsteps in the same direction. However, you should still be really careful when doing so since it's probably for the best if you stay undetected for now.

You can see a stone plate here.

* * *

>teleport to geysiria
Spaceship Bridge
Shit, this was exhausting. The impact of the landing was pretty heavy. The Spaceship Bridge still works though. Hm, on your left side there is a little bit of food, to your right there is a small storage unit with an encryption key  Examine this key in order to see if it's the right combination . In order to leave the spaceship, you have to head south.

You can see an encryptionkey here.

>takeall
That's not a verb I recognise.

>take all
encryptionkey: Taken.

>s
Spaceship Storage
Taking a quick look inside the storage room doesn't seem to reveal anything particularly interesting. There are only some random souvenirs from your previous intergalactic travels and your locker which you haven't opened in ages.  Examine this locker in order to see if the key fits . If you wish to leave the spaceship immediately, head south.

You can see a lockbox (closed) here.

* * *

>n
Spaceship Storage
Taking a quick look inside the storage room doesn't seem to reveal anything particularly interesting. There are only some random souvenirs from your previous intergalactic travels and your locker which you haven't opened in ages.  Examine this locker in order to see if the key fits . If you wish to leave the spaceship immediately, head south.

You can see a lockbox (closed) here.

>unlock locker with encryptionkey
You can't see any such thing.

>unlock lockbox with encryptionkey
You unlock the lockbox.

* * *

>open lockbox
You open the lockbox, revealing an underwater system map.

>take all
underwater system map: The Geysiria Underwater Cave System Map. Without this tool you are pretty much lost and won't be able to leave this planet as you have to stop the huge ash cloud and geysir fountains. The map will help you get to the location where you'll be able to stop pretty much every action going on here on this vast planet. But be careful - don't lose it and read the instructions carefully, as you don't have second chances here.

>s
Spaceship Exit
Bye Spaceship. Let's go and have a look around. There's more to this planet than ash clouds, lava and rocky landscape if you use your knowledge and cleverness. On the western side you see massives waves detonating on the shores. You turn around and you see a vastland of volcanoes, mountains and dry land. This must be the vast landscape of Geysiria. First I try to explain the map a little - sorry, I don't know everything, but I think I can give you some hints I know from King Kamehameha. Here are your options, respectively the options I know: On the horizon, in the east, there is your landing zone, where you normally land. You landed a little more west on a steep cliff but you were lucky, the spaceship is still in one piece. Here you can either head north on the Kamehameha Route to the North Shore to hopefully reach the big area where all the infamous geysirs are. Your second option is heading towards the little village which is in the eastern part of the planet. You can explore the region of all the volcanoes here. To this point I don't know much more. Keep me updated and I will try and connect the dots at the next stops.

Head east to leave the spaceship.

* * *

>e
Field of Death
People say there are some land mines still in this area. You can go back to the Landing Zone and try another way. In order to master the Kamehameha Route which only King Kamehameha passed a few hundred years ago you need some tools to get access to the Seaside. Be patient, calm and collected and make good choices. You would be the second one to master this way full of obstacles. You know you have to pass that massive rock, too.

But be careful, check it out first. Maybe it's a not a good idea - I don't know. Examine the land mine. Take the land mine.

Head west - back onto the Kamehameha Route or remain on the Field of Death - you won't make it very long until one of those land mines will detonate and kill you, so I'd recommend heading back to the trail.

You can see a land mine here.

>take all
land mine: Taken.

>e
Too dangerous, the Field of Death is huge, you really don't want to get lost here.

* * *

>detonate rock
I only understood you as far as wanting to detonate.

>detonate massive
I only understood you as far as wanting to detonate.

>n
(first opening the massive rock)
It seems to be locked.

>unlock rock
What do you want to unlock the massive rock with?

>unlock rock with land mine
You unlock the massive rock.

>i
You are carrying:
  a land mine
  an underwater system map
  a backpack (being worn)

>open rock
You open the massive rock.

>n
North Shore
The final point where King Kamehameha landed back when you weren't existing. This is actually the last location where King Kamehameha was known to be alive. He built his Ho'kulea and set sail to reach another planet. His return to his home planet should be very soon but he never came back. By the looks of the ocean I'm not too sure if he made it behind the outer reefs. It is a very dangerous place and I recommend to stay out of the water. Or are you keen enough to set sail to the next planet? I don't think so.

You are in the far north of Geysiria. Actually, the most northern point on the planet. Beautiful views into the galaxy.

You can either head back south in order to go another way or you head east towards the geysirs which gave the planet its name.

You can see a massive rock and a waterkey here.

>take all
waterkey: Taken.

>e
Geysir Chambers
Whooooosh, whoooosh - Geysirs everywhere. Massive chambers of lava stone push enormous water massses into the air - what a breathtaking phenomenon! You have been hiking for hours with only a few liters of fresh water. The way was very long and hard, the dangers of falling and getting caught by monstrous waves were contstant. But you made it. Congratulations. So what next? First, you should drink as much as you can, some Geysirs here have fresh drinking water, some are saltwater. You will find out pretty quickly. Now it's time to to get serious. How long can you rest on this planet? Think quick and choose your options wisely. Did you find the underwater map of the underwater volcano system in the spaceship? If yes, you will find the heart of the volcano with the help of this map. Otherwise, you will have to choose another option... In between all the geysirs you see a little hole which has a little sign on it saying MAGIC HOLE.

You can see a Magic Hole here.

>d
Pu'ulau Cave
The infamous Pu'ulau Cave - no one has ever been here before. Many have had the underwater map, but congratulations again, you are the first one to ever connect the dots and find the right way into this little and very complex underwater system. Do you see the light at the end of the tunnel? This is the heart of the volcano. If you reach it before a fire storm from Paia Cave coes - you will destroy every volcano on this planet and you can head back to your spaceship to leave the extincted area.

Two options: Go east in order to head a volcanic cave called Paia Cave. You'll find a connection to another part of the planet there.

Climb UP to exit the cave system through the geysir entry. Head west to reach the heart of the whole Geysiria system.

You can see a waterdagger here.

>take all
waterdagger: (putting the underwater system map into the backpack to make room)
Taken.

>w
The Heart of Geysiria
This is your last step to finally stop all the ash clouds and the constant lava flow above ground. The underwater system map led you here - you should make use of your one and only tool that will fit into the little heart that is at the end of this tiny corridor. May Geysiria rest in peace.

Examine the daggerhole in order to see if there are hidden dangers or something that will prevent you from putting the waterdagger into the probably fitting hole. You also have the option to walk back (west).

You can see a daggerhole (closed) here.

>unlock water dagger hole
You can't see any such thing.

>water dagger
That's not a verb I recognise.

>look
The Heart of Geysiria
This is your last step to finally stop all the ash clouds and the constant lava flow above ground. The underwater system map led you here - you should make use of your one and only tool that will fit into the little heart that is at the end of this tiny corridor. May Geysiria rest in peace.

Examine the daggerhole in order to see if there are hidden dangers or something that will prevent you from putting the waterdagger into the probably fitting hole. You also have the option to walk back (west).

You can see a daggerhole (closed) here.

>unlock daggerhole with water dagger
You can't see any such thing.

>i
You are carrying:
  a waterdagger
  a waterkey
  a land mine
  a backpack (being worn)
    an underwater system map

>unlock daggerhole with waterdagger
You unlock the daggerhole.

* * *

>helper
---
This is the help section, you will get a list of essential commands that you can use in the game.

Basic Commands

look - shows you the room you are currently in
 e(x)amine (something)- get information about a thing or a person (if no object or person is specified, something will be examined automatically, if it's the only thing in the room
 take (something) - take and carry something
 (i)nventory - show what you are carrying

(e)ast - go east
 (w)est - go west
 (s)outh - go south
 (n)orth - go north

save - produce a local save file on your computer
 restore - load a local save file
 quit - quit the game

Frizza

ask (someone) about (something) - the typical way to begin a dialogue, the topics you can ask about are printed bold in the text beforehand
 answer (something) to (someone) - the typical way to respond to questions, the topics you can answer are printed bold in the text beforehand
 wait - wait some time, some situations may require this
 wear (something) - put clothing on
 take off (something )- take off clothing
 approach (something)-  try to draw closer to an object, some situations may require this
 extract - extract a sample from the Flux Current
 push (something) - try to push something, if you have a tool it will be used automatically
 insert (something) into (something) or put (something) into (somehting) - insert whatever generates enough power into the power unit

End of help section
---

>e
Ascent
The mountains are composed of stone in various shades of red and reach far to the sky. In between the cliffs and sheers you see a narrow path winding up, at the beginning of which are small pillars - one marked with an insignia.. There is no clue on where it might lead, but you could find out.

You can also go west, back to the Landing Zone

>u
You have the feeling of being watched. You wouldn't want to climb the cliffs if someone is around. Maybe looking around would reveal whoever is hiding.

>x dunia
A lean but athletic figure, wrapped by several layers of what looks like tough leather. In a small gap of her hood you can see glinting eyes that reveal a sharp mind. You could ask her about everything surrounding you: the Flux, the Duju, the City ... for a list of all topics, "ask Dunia about topics".

"You are painfully near to trespass holy ground, stranger. I would advise against it. Who are you, anyway? You don't look like a Techie. Tell me your name."

>answer axesto
(to Dunia)
"What a strange name. It doesn't matter anyway - there's only one thing I need to know: are you on the side of the Duju or of the Techies?"

>answer duju
(to Dunia)
"Well then, that's not a bad way to start. Thinking about it - an outsider might be what we need. I'll introduce you to someone, and that is not an invitation."

 With seemingly little effort she climbs down the cliffs to your level, before insistently inviting you to come with her.
 Both of you walk through the scraggy landscape, her leading the way with distinct commands. Slowly you approach an archlike structure, close to one branch of the Flux.

Flux Gate

As you get nearer you perceive a couple of bulky shapes, guarding the entrance to the structure. Some hundred meters in front of the entrance your companion turns to you."Try not to look too provoking."

You know why while passing the guards: each and every one of them gazes at you. In consideration of the thick armour plates, the rather oversized guns and their radiating blue glow you refrain from making any quick motions.
Inside you find yourself in the midst of a small-sized hall, that doesn't appear to justify any of the expenditure you just encountered. In the back you spot an opening and a staircase, leading downwards. To the left there is a full board of controls and two figures unhastily operating them. You can't look around any more, as you are approached quickly by an impressively sized Duju, already bellowing words in your direction with a booming voice.

"Dunia! Who is this? Explain yourself!"

"A guest of sorts. He stumbled about the Ascent when I found him. I don't think he's a Techie, at least he has slightly better manners and he keeps his voice down to a sensible level when talking. Besides, I thought about his use in regard to certain issues, due to his undujulike appearance."

Both eyeball you thoroughly for what seems like hours. Eventually, the massive Duju makes a quick motion towards Dunia, indicating her to follow him. He shoots a last glance at you, accompanied by a warning.

"Don't let yourself be found sniffing around somewhere, it would not contribute to your wellbeing."

They march off, disappearing into the opening at the end of the hall. You are not guarded, it seems like you could look around. Of course you could also do as you were told and wait.

>wait
You stand still where you were left. Time passes. However, that seems to be the only thing to change. You ought to wait a little longer before Dunia and Du'un return.

>wait
You pass the time looking closer at your surroundings, but you can't interpret all too much from the metallic alien structures. The architecture somewhat reminds you of the spiritual buildings on your home planet, as for the arching walls and the high ceiling. The only thing you hear is the distant, lamish flow of the Flux and the dull sounds of the two operators at the console. You ought to wait a little longer before Dunia and Du'un return.

>wait
Finally you see the two Duju returning from the opening. As they approach, the big one actually looks amazed by your decent behaviour.

"It seems like you did as you were told. Maybe you don't have no ill intent after all. Indeed - that is exactly what we're going to find out, if you're willing. But you see, we don't want to force anything on you, you are free to leave. But if you are interested in helping us, we would be glad.

"He hands you something that distantly reminds you of a fishing net, only is this one almost ridiculously overengineered. You must have a rather puzzled look to your face, as Du'un starts to explain soon after. 

"That is a Flux Extractor, the Techies call them "Scoops". It is used to extract small portions of the Flux and isolate it for examination. If you want to help us out, showing us that you have no evil intent in the process, go and extract two samples of the Flux: one from the current before it passes through this gate, from the Flux before the Gate, and one after it has done so, from the Flux beyond the Gate. I am sure you will find the proper locations for this purpose yourself. When you are done or have any questions, return here to the Flux Gate, Dunia will be to your assistance, she will stay here at the Flux Gate. You can always ask her about the Extraction, or about help in general for that matter."

You receive a Flux Extractor.

With that, Du'un goes off, quickly descending the stairs at the back of the hall. You are left with a vague task and Dunia, who doesn't look very pleased.

"To your assitance, eh? Well, better than climbing that awful piece of a mountain, I suppose. Alright, if you need anything or want to ask me anything: you will find me here, at the Flux Gate. Come back to me whenever you want."

>ask dunia about help
She giggles a bit.

"It is simple, you will see when you get to the Flux. Just dip it in."

She shows a devilish grin. 

"Oh, but there's something I can help you with."

Suddenly Dunia grasps a corner of her leathery clothing and, with one swoosh, unwraps it from her body. Underneath, a sinewy, bluish body comes to appearance.

"Here, take this, it will prevent the Flux from disintegrating you all too fast, when you wear it."

The devilish grin emerges again.

"And stop staring."

You receive a Sinkan Cloak.

>e
Wasteland
A pitiful piece of land. Black sand, red rocks and some sickish looking plants. If you are not looking for something particular there is no need to linger.

You can go west, to the Flux Gate, north, to the edge of the city, and south, back to the Landing Zone.

>s
Wasteland
A pitiful piece of land. Black sand, red rocks and some sickish looking plants. If you are not looking for something particular there is no need to linger.

You can go west, to the Flux Gate, north, to the edge of the city, and south, back to the Landing Zone.

Landing Zone
Your crash site. You can go in all directions. You remeber having seen civilization-like shapes to the south and to the north. To the east  there is a huge mountain, to the west there seems to be a Flux. 

You can see a Discharged Spaceship (in which is a Power Unit (empty)) here.