Welcome to your journey, Axesto! Take a seat, sit back and enjoy. Hier fehlt noch die Geschichte, warum Axesto seinen Heimatplaneten Fidatis verlassen hat. Der erste Planeten, den du ansteuerst, nennt sich Sitis. Der einzige Planeten, den du von deiner Heimat aus als goldbraun leuchtenden Stern wahnehmen konntest. Du hast dich schon immer gefragt, wer und was dort lebt. Also los gehts!

On the Lookout
An Interactive Fiction by Daniel, Tim, Franziska, Kevin, Tobias
Release 1 / Serial number 170804 / Inform 7 build 6M62 (I6/v6.33 lib 6/12N) SD

Your arrival point. The Flat Rock
You arrive on a planet called Sitis. You think the landing went great but as you leave your spaceship, you realise that two of your three water container broke down. Without minimum one new watertank you can not continue your journey. Far away in the east you recognise some kind of different rooftops. Maybe someones living there who could help you?

You can see Teleportation Stone - Sitis, Teleportation Stone - Gaisetto, Teleportation Stone - Geysiria, Teleportation Stone - Frizza and Teleportation Stone - Kaldríss here.

>helper
---
This is the help section, you will get a list of essential commands that you can use in the game.

Basic Commands

look - shows you the room you are currently in
 e(x)amine (something)- get information about a thing or a person (if no object or person is specified, something will be examined automatically, if it's the only thing in the room
 take (something) - take and carry something
 (i)nventory - show what you are carrying

(e)ast - go east
 (w)est - go west
 (s)outh - go south
 (n)orth - go north

save - produce a local save file on your computer
 restore - load a local save file
 quit - quit the game

Sitis
End of help section
---

>e
The Wide Desert
You've reached the Desert of Sitis. It gives you two things: First, an impression of what whole Sitis looks like - sandy, dry, with some deep stone canyons and huge rocks afar. But although this planet does not seem to be a place to life, the Desert also gives you the chance to discern that you are not alone. There IS life! When you look north, directly in front of you is a long corrugated iron bridge, guiding over one of those ravines. You can not access the bridge, it is blocked with a barbed wire fence, but straight ahead, at the end you see a majestic sandstone palace. In the bridge's middel, a wooden ladder leads to an enormous square block in the east. Likewise it is built out of stone and gives a somber impression. If you look east from the point you are standing at right now, you see the kind of a rock mine. In the south you recognise a lot of small white houses surrounded by a rampart. It seems like people are living here.

>w
Your arrival point. The Flat Rock
You can see your spaceship here.

You can see Teleportation Stone - Sitis, Teleportation Stone - Gaisetto, Teleportation Stone - Geysiria, Teleportation Stone - Frizza and Teleportation Stone - Kaldríss here.

>helper
---
 This is the help section, you will get a list of essential commands that you can use in the game.

look - shows you the room you are currently in
 e(x)amine (something)- get information about a thing or a person (if no object or person is specified, something will be examined automatically, if it's the only thing in the room
 take (something) - take and carry something
 (i)nventory - show what your are carrying

(e)ast - go east
 (w)est - go west
 (s)outh - go south
 (n)orth - go north

save - produce a local save file on your computer
 restore - load a local save file
 quit - quit the game

End of help section
---

>showme
Your arrival point. The Flat Rock - room
    yourself - person
        backpack (worn) - player's holdall
    Teleportation Stone - Sitis
    Teleportation Stone - Gaisetto
    Teleportation Stone - Geysiria
    Teleportation Stone - Frizza
    Teleportation Stone - Kaldríss

>showme counter
There seems to be no such object anywhere in the model world.

* * *

>take gaisetto
Landingzone
You are standing an a clearing. South of you is your spaceship right in front of a cliff. All the other directions you are surrounded by the deep green of the jungle.

* * *

>helper
---
 This is the help section, you will get a list of essential commands that you can use in the game.

look - shows you the room you are currently in
 e(x)amine (something)- get information about a thing or a person (if no object or person is specified, something will be examined automatically, if it's the only thing in the room
 take (something) - take and carry something
 (i)nventory - show what your are carrying

(e)ast - go east
 (w)est - go west
 (s)outh - go south
 (n)orth - go north

save - produce a local save file on your computer
 restore - load a local save file
 quit - quit the game

Gaisetto

End of help section
---

>take geysiria
You can't see any such thing.

>w
Landingzone
You are standing an a clearing. South of you is your spaceship right in front of a cliff. All the other directions you are surrounded by the deep green of the jungle.

You can see Teleportation Stone - Kaldríss, Teleportation Stone - Frizza, Teleportation Stone - Geysiria, Teleportation Stone - Gaisetto and Teleportation Stone - Sitis here.

>take geysiria
Spaceship Bridge
Shit, this was exhausting. The impact of the landing was pretty heavy. The Spaceship Bridge still works though. Hm, on your left side there is a little bit of food, to your right there is a small storage unit with an encryption key  Examine this key in order to see if it's the right combination . In order to leave the spaceship, you have to head south.

You can see an encryptionkey here.

>helper
---
 This is the help section, you will get a list of essential commands that you can use in the game.

look - shows you the room you are currently in
 e(x)amine (something)- get information about a thing or a person (if no object or person is specified, something will be examined automatically, if it's the only thing in the room
 take (something) - take and carry something
 (i)nventory - show what your are carrying

(e)ast - go east
 (w)est - go west
 (s)outh - go south
 (n)orth - go north

save - produce a local save file on your computer
 restore - load a local save file
 quit - quit the game

Gaisetto

End of help section
---

>s
Spaceship Storage
Taking a quick look inside the storage room doesn't seem to reveal anything particularly interesting. There are only some random souvenirs from your previous intergalactic travels and your locker which you haven't opened in ages.  Examine this locker in order to see if the key fits . If you wish to leave the spaceship immediately, head south.

You can see a lockbox (closed) here.

>helper
---
 This is the help section, you will get a list of essential commands that you can use in the game.

look - shows you the room you are currently in
 e(x)amine (something)- get information about a thing or a person (if no object or person is specified, something will be examined automatically, if it's the only thing in the room
 take (something) - take and carry something
 (i)nventory - show what your are carrying

(e)ast - go east
 (w)est - go west
 (s)outh - go south
 (n)orth - go north

save - produce a local save file on your computer
 restore - load a local save file
 quit - quit the game

Geysiria

End of help section
---

>n
Spaceship Bridge
Shit, this was exhausting. The impact of the landing was pretty heavy. The Spaceship Bridge still works though. Hm, on your left side there is a little bit of food, to your right there is a small storage unit with an encryption key  Examine this key in order to see if it's the right combination . In order to leave the spaceship, you have to head south.

You can see Teleportation Stone - Kaldríss, Teleportation Stone - Frizza, Teleportation Stone - Geysiria, Teleportation Stone - Gaisetto, Teleportation Stone - Sitis and an encryptionkey here.

>s
Spaceship Storage
Taking a quick look inside the storage room doesn't seem to reveal anything particularly interesting. There are only some random souvenirs from your previous intergalactic travels and your locker which you haven't opened in ages.  Examine this locker in order to see if the key fits . If you wish to leave the spaceship immediately, head south.

You can see a lockbox (closed) here.

>s
Spaceship Exit
Bye Spaceship. Let's go and have a look around. There's more to this planet than ash clouds, lava and rocky landscape if you use your knowledge and cleverness. On the western side you see massives waves detonating on the shores. You turn around and you see a vastland of volcanoes, mountains and dry land. This must be the vast landscape of Geysiria. First I try to explain the map a little - sorry, I don't know everything, but I think I can give you some hints I know from King Kamehameha. Here are your options, respectively the options I know: On the horizon, in the east, there is your landing zone, where you normally land. You landed a little more west on a steep cliff but you were lucky, the spaceship is still in one piece. Here you can either head north on the Kamehameha Route to the North Shore to hopefully reach the big area where all the infamous geysirs are. Your second option is heading towards the little village which is in the eastern part of the planet. You can explore the region of all the volcanoes here. To this point I don't know much more. Keep me updated and I will try and connect the dots at the next stops.

Head east to leave the spaceship.

>n
Spaceship Storage
Taking a quick look inside the storage room doesn't seem to reveal anything particularly interesting. There are only some random souvenirs from your previous intergalactic travels and your locker which you haven't opened in ages.  Examine this locker in order to see if the key fits . If you wish to leave the spaceship immediately, head south.

You can see a lockbox (closed) here.

>n
Spaceship Bridge
Shit, this was exhausting. The impact of the landing was pretty heavy. The Spaceship Bridge still works though. Hm, on your left side there is a little bit of food, to your right there is a small storage unit with an encryption key  Examine this key in order to see if it's the right combination . In order to leave the spaceship, you have to head south.

You can see Teleportation Stone - Kaldríss, Teleportation Stone - Frizza, Teleportation Stone - Geysiria, Teleportation Stone - Gaisetto, Teleportation Stone - Sitis and an encryptionkey here.

* * *

>exit
But you aren't in anything at the moment.

>end
Are you sure you want to quit?

* * *

>take geysiria
Spaceship Bridge
Shit, this was exhausting. The impact of the landing was pretty heavy. The Spaceship Bridge still works though. Hm, on your left side there is a little bit of food, to your right there is a small storage unit with an encryption key  Examine this key in order to see if it's the right combination . In order to leave the spaceship, you have to head south.

You can see an encryptionkey here.

>heler
That's not a verb I recognise.

>s
Spaceship Storage
Taking a quick look inside the storage room doesn't seem to reveal anything particularly interesting. There are only some random souvenirs from your previous intergalactic travels and your locker which you haven't opened in ages.  Examine this locker in order to see if the key fits . If you wish to leave the spaceship immediately, head south.

You can see a lockbox (closed) here.

>helper
---
This is the help section, you will get a list of essential commands that you can use in the game.

Basic Commands

look - shows you the room you are currently in
 e(x)amine (something)- get information about a thing or a person (if no object or person is specified, something will be examined automatically, if it's the only thing in the room
 take (something) - take and carry something
 (i)nventory - show what you are carrying

(e)ast - go east
 (w)est - go west
 (s)outh - go south
 (n)orth - go north

save - produce a local save file on your computer
 restore - load a local save file
 quit - quit the game

Geysiria
End of help section
---

>n
Spaceship Bridge
Shit, this was exhausting. The impact of the landing was pretty heavy. The Spaceship Bridge still works though. Hm, on your left side there is a little bit of food, to your right there is a small storage unit with an encryption key  Examine this key in order to see if it's the right combination . In order to leave the spaceship, you have to head south.

You can see Teleportation Stone - Kaldríss, Teleportation Stone - Frizza, Teleportation Stone - Geysiria, Teleportation Stone - Gaisetto, Teleportation Stone - Sitis and an encryptionkey here.

>take encryptionkey
Taken.

>s
Spaceship Storage
Taking a quick look inside the storage room doesn't seem to reveal anything particularly interesting. There are only some random souvenirs from your previous intergalactic travels and your locker which you haven't opened in ages.  Examine this locker in order to see if the key fits . If you wish to leave the spaceship immediately, head south.

You can see a lockbox (closed) here.

>unlock lockbox
What do you want to unlock the lockbox with?

>unlock lockbox with encryptionkey
You unlock the lockbox.

>open lockbox
You open the lockbox, revealing an underwater system map.

>take map
The Geysiria Underwater Cave System Map. Without this tool you are pretty much lost and won't be able to leave this planet as you have to stop the huge ash cloud and geysir fountains. The map will help you get to the location where you'll be able to stop pretty much every action going on here on this vast planet. But be careful - don't lose it and read the instructions carefully, as you don't have second chances here.

>s
Spaceship Exit
Bye Spaceship. Let's go and have a look around. There's more to this planet than ash clouds, lava and rocky landscape if you use your knowledge and cleverness. On the western side you see massives waves detonating on the shores. You turn around and you see a vastland of volcanoes, mountains and dry land. This must be the vast landscape of Geysiria. First I try to explain the map a little - sorry, I don't know everything, but I think I can give you some hints I know from King Kamehameha. Here are your options, respectively the options I know: On the horizon, in the east, there is your landing zone, where you normally land. You landed a little more west on a steep cliff but you were lucky, the spaceship is still in one piece. Here you can either head north on the Kamehameha Route to the North Shore to hopefully reach the big area where all the infamous geysirs are. Your second option is heading towards the little village which is in the eastern part of the planet. You can explore the region of all the volcanoes here. To this point I don't know much more. Keep me updated and I will try and connect the dots at the next stops.

Head east to leave the spaceship.

>e
Landing Zone
It is windy, dusty and your sight is limited to only a few meters. Look around, as you maybe realised you are on Geysiria. The name comes from its massive Geysirs in the north east of the planet which will maybe help you out of this unpleasant vastland. Hmmm, or is it more clever to head to the village in order to search for hints in this little ghost town? I don't know, you decide.

You have three options: You can either go back to the spaceship (west), head north towards the northern shores and the geysir areas or you can hike east towards the volcanoes.

>n
Kamehameha Route
A very famous route you are walking on. A century ago King Kamehameha ventured along this very tiny path you can barely see anymore. He made this entire path for about two hundred kilometers until Hale'iwa, a little spot on the northern Shores of Geysiria. This little spot is called after a bird that is living there. It is a little outlook nestled in a vast land where you can overlook the whole North Shore. The windward west side, the eastern side where many land mines lay below the ground and the ocean is what you can see here.

Three options: head south, back to the Landing Zone. Hike north on the trail towards the Geysirs.

You can see a massive rock here.

>n
Field of Death
People say there are some land mines still in this area. You can go back to the Landing Zone and try another way. In order to master the Kamehameha Route which only King Kamehameha passed a few hundred years ago you need some tools to get access to the Seaside. Be patient, calm and collected and make good choices. You would be the second one to master this way full of obstacles. You know you have to pass that massive rock, too.

But be careful, check it out first. Maybe it's a not a good idea - I don't know. Examine the land mine. Take the land mine.

Head west - back onto the Kamehameha Route or remain on the Field of Death - you won't make it very long until one of those land mines will detonate and kill you, so I'd recommend heading back to the trail.

You can see a land mine here.

Take the land mine.

>take land mine
Taken.

>x mine
You see nothing special about the land mine.

Be careful, a land mine is not a toy! I know you're a big boy so you should be able to handle a little land mine. This one should help you get this massive rock out of your way.

>n
Too dangerous, the Field of Death is huge, you really don't want to get lost here.

>e
Too dangerous, the Field of Death is huge, you really don't want to get lost here.

>w
Kamehameha Route
A very famous route you are walking on. A century ago King Kamehameha ventured along this very tiny path you can barely see anymore. He made this entire path for about two hundred kilometers until Hale'iwa, a little spot on the northern Shores of Geysiria. This little spot is called after a bird that is living there. It is a little outlook nestled in a vast land where you can overlook the whole North Shore. The windward west side, the eastern side where many land mines lay below the ground and the ocean is what you can see here.

Three options: head south, back to the Landing Zone. Hike north on the trail towards the Geysirs.

You can see a massive rock here.

>n
(first opening the massive rock)
It seems to be locked.

>x rock
You see nothing special about the massive rock.

Shit, you have been walking for a few hours now on this tiny trail and now there is this huge rock in front of you. The surface is very smooth, there is no grip, you won't be able to climb over it. You need to burst it away in order to continue your journey.

>destroy rock
Violence isn't the answer to this one.

>use land mine
That's not a verb I recognise.

>x mine
You see nothing special about the land mine.

Be careful, a land mine is not a toy! I know you're a big boy so you should be able to handle a little land mine. This one should help you get this massive rock out of your way.

>s
Landing Zone
It is windy, dusty and your sight is limited to only a few meters. Look around, as you maybe realised you are on Geysiria. The name comes from its massive Geysirs in the north east of the planet which will maybe help you out of this unpleasant vastland. Hmmm, or is it more clever to head to the village in order to search for hints in this little ghost town? I don't know, you decide.

You have three options: You can either go back to the spaceship (west), head north towards the northern shores and the geysir areas or you can hike east towards the volcanoes.

>e
Pe'ahi Trail
The well known Pe'ahi Trail, better known as Jaws is a nerve -wracking trail with lots of ups and downs - you will walk for hours eventhough the walk itself is only a few kilometers long. On this part of the planet the temperature at day is around 35 to 40 degrees celcius, so you might want to hike in the early hours, in the evening or even at night. In the night time you will see a few animals but they are shy and you won't see many anyway. But if you do, say hi and be happy about some company eventhough the animals don't speak your language.

Three options: head west, back to the Landing Zone. From the Landing Zone you can walk on the Kamehameha Route and eventually reach the northern end of the planet. Hike east on the Pe'ahi Trail towards the volcanoes. Take the tiny path to Lihue - which is south from where you are.

>e
Haiku Volcano
Very high, very bad sight and dangerous drop-offs characterize the Haiku Volcano. Many centuries ago this volcano area has been formed and Haiku Volcano is the highest one. Imagine the power that has been set free in that eruption. This must have been a massive spectacke. Ah, yeah and you can climb that infamous volcano - if it's not too cloudy you will have a great view over... well... wasteland. You know it, only deserted landscape without much more. But anyway, standing on top something is cool isn't it? Decide for yourself if it's worth the hassle. I heard a rumour that a mysterious cave is underneath this particular volcano...

Your options here are: Go west to walk the Pe'ahi trail back to the little village Lihue and therefore direction Landing Zone. You can also east on the Na Pali trail to reach the other end of Lihue. Last but not least, as you might know already if you're able to read between the lines you can also step down here. Try it, going down doesn't hurt. Only sometimes.

You can see lava keyhole here.

>e
There is no way to advance in this direction.

>d
Haiku Volcano
Very high, very bad sight and dangerous drop-offs characterize the Haiku Volcano. Many centuries ago this volcano area has been formed and Haiku Volcano is the highest one. Imagine the power that has been set free in that eruption. This must have been a massive spectacke. Ah, yeah and you can climb that infamous volcano - if it's not too cloudy you will have a great view over... well... wasteland. You know it, only deserted landscape without much more. But anyway, standing on top something is cool isn't it? Decide for yourself if it's worth the hassle. I heard a rumour that a mysterious cave is underneath this particular volcano...

Your options here are: Go west to walk the Pe'ahi trail back to the little village Lihue and therefore direction Landing Zone. You can also east on the Na Pali trail to reach the other end of Lihue. Last but not least, as you might know already if you're able to read between the lines you can also step down here. Try it, going down doesn't hurt. Only sometimes.

You can see lava keyhole here.

It's closed. There is a thick layer of lava mass which has a little hole in it - you will need a special key to open this keyhole. Go find it brother.

(first opening lava keyhole)
It seems to be locked.

>n
You can't go that way.

>s
Na Pali Trail
Na Pali is Geysirian and means The Long Walk. You will walk for a while I guess. But that's not a problem for you as you are a tough and strong dude, aren't you Axesto?

You can either head south and stay on the trail to reach the little ghost town Lihue, head north to reach the highest volcano, the Haiku Volcano or head west in order to go back to the Landing Zone to try another way into the heart of the planet.

>s
The Old Chapel
Tons of figures you know from the bible and other holy papers are exhibited here. No one knows why, maybe they explain the gold rush where people from all over the galaxy flocked to this particular place. Some seemed to be very religious and brought some belongings along with them. The ceiling is a little bit demolished but the chapel as a whole doesn't look too bad actually. It's quite an intimidating place because there is not a soul in sight and the pictures on the wall have angry faces everywhere. In the corner where the confessional box is there is an arsenal of a few old weapons including swords and a dagger. The dagger might help you as it has a volcano engraved. The coffin under the altar contains something you will need for sure. Somewhere in the little Village there is a hidden key for that particular coffin. Go search for that key and come back later.

In the south you'll find the house where the Mayor used to politically tie the ropes for Lihue. If you head north you will walk on another long trail in order to reach the highest Volcano in the area. In the west, there is the center of Lihue.

You can see a coffin (closed) here.

>w
Lihue
A little Village called Lihue nestled in - oh wonder - deserted landscape. Lihue is a ghost town. Many thousand years ago this little town used was rich because of a gold rush. It only took a few years until the little village turned into a ghost town as the gold rush didn't take very long. You have many houses you can look into and search for some hints in order to leave this planet as soon as possible. Stroll around, here are a few spots you should definitely check out. There is an interesting old building right next to the big market place - you will probably need a special key to open the doors there... Around the place there are lots of other buildings, the house of the mayor with a huge amount of old files and many hidden treasure boxes, a little hut where they used to sell Galaxy Coke and a little chapel which kind of looks a bit intimidating.

You are situated in the centre of Lihue. You can head into each direction. The volcano is in north east from where you are at the moment. Every other part of Lihue is somewhere around you. Go and explore a little.

>Error exploring east from Lihue.

>s
The Blunt Box
You are standing in front of a little hut, there is not much here except a little toolbox. Back in the day they used to sell Galaxy Coke here as it was legal. The only thing the inhabitants of the village didn't know was the fact that the owners of the little hut regularly stole from the Lihue people. That's the reason why you see this little picklock on top of every other tool. Who needs a grinder, some lamps and spades when you have a picklock that opens any door and makes you rich while other people sleep?

Examine the picklock in order to see if it's a helpful tool or not. The Blunt Box is situated south of the Lihue town center and east of the Mayor's house. Every other direction is too dangerous as the Blunt Box is situated on a very exposed location.

You can see a picklock here.

>e
The Mayor Mansion
The house where the mayor lived. Some say he was a good mayor, some others say he was corrupt, an alcoholic and he had a feed of clay for cocaine. But there is no proof. Maybe you find a cocaine line somewhere but I guess it is too late for you to play detective. You better check the surroundings in this house in order to find something you really need.

The house where the Mayor resided is far in the south of Lihue. You can either head north towards the Old Chapel or you head west to the Blunt Box.

You can see a case (closed) here.

>Error exploring west from The Mayor Mansion.

>s
You can't go that way.

>Error exploring west from The Mayor Mansion.

>w
The Blunt Box
You are standing in front of a little hut, there is not much here except a little toolbox. Back in the day they used to sell Galaxy Coke here as it was legal. The only thing the inhabitants of the village didn't know was the fact that the owners of the little hut regularly stole from the Lihue people. That's the reason why you see this little picklock on top of every other tool. Who needs a grinder, some lamps and spades when you have a picklock that opens any door and makes you rich while other people sleep?

Examine the picklock in order to see if it's a helpful tool or not. The Blunt Box is situated south of the Lihue town center and east of the Mayor's house. Every other direction is too dangerous as the Blunt Box is situated on a very exposed location.

You can see a picklock here.

>Error exploring east from The Blunt Box.

>take all
picklock: Taken.

>Error exploring east from The Blunt Box.

>e
The Mayor Mansion
The house where the mayor lived. Some say he was a good mayor, some others say he was corrupt, an alcoholic and he had a feed of clay for cocaine. But there is no proof. Maybe you find a cocaine line somewhere but I guess it is too late for you to play detective. You better check the surroundings in this house in order to find something you really need.

The house where the Mayor resided is far in the south of Lihue. You can either head north towards the Old Chapel or you head west to the Blunt Box.

You can see a case (closed) here.

>Error exploring west from The Mayor Mansion.

>unlock case with picklock
You unlock the case.

>Error exploring west from The Mayor Mansion.

>open cae
You can't see any such thing.

>Error exploring west from The Mayor Mansion.

>open cae
You can't see any such thing.

>Error exploring west from The Mayor Mansion.

>open case
You open the case, revealing an old_key.

>Error exploring west from The Mayor Mansion.

>take old_key
(putting the underwater system map into the backpack to make room)
Taken.

>Error exploring west from The Mayor Mansion.

>s
You can't go that way.

>Error exploring west from The Mayor Mansion.

>w
The Blunt Box
You are standing in front of a little hut, there is not much here except a little toolbox. Back in the day they used to sell Galaxy Coke here as it was legal. The only thing the inhabitants of the village didn't know was the fact that the owners of the little hut regularly stole from the Lihue people. That's the reason why you see this little picklock on top of every other tool. Who needs a grinder, some lamps and spades when you have a picklock that opens any door and makes you rich while other people sleep?

Examine the picklock in order to see if it's a helpful tool or not. The Blunt Box is situated south of the Lihue town center and east of the Mayor's house. Every other direction is too dangerous as the Blunt Box is situated on a very exposed location.

>Error exploring east from The Blunt Box.

>e
The Mayor Mansion
The house where the mayor lived. Some say he was a good mayor, some others say he was corrupt, an alcoholic and he had a feed of clay for cocaine. But there is no proof. Maybe you find a cocaine line somewhere but I guess it is too late for you to play detective. You better check the surroundings in this house in order to find something you really need.

The house where the Mayor resided is far in the south of Lihue. You can either head north towards the Old Chapel or you head west to the Blunt Box.

You can see a case (empty) here.

>Error exploring west from The Mayor Mansion.

>w
The Blunt Box
You are standing in front of a little hut, there is not much here except a little toolbox. Back in the day they used to sell Galaxy Coke here as it was legal. The only thing the inhabitants of the village didn't know was the fact that the owners of the little hut regularly stole from the Lihue people. That's the reason why you see this little picklock on top of every other tool. Who needs a grinder, some lamps and spades when you have a picklock that opens any door and makes you rich while other people sleep?

Examine the picklock in order to see if it's a helpful tool or not. The Blunt Box is situated south of the Lihue town center and east of the Mayor's house. Every other direction is too dangerous as the Blunt Box is situated on a very exposed location.

>Error exploring east from The Blunt Box.

>n
Lihue
A little Village called Lihue nestled in - oh wonder - deserted landscape. Lihue is a ghost town. Many thousand years ago this little town used was rich because of a gold rush. It only took a few years until the little village turned into a ghost town as the gold rush didn't take very long. You have many houses you can look into and search for some hints in order to leave this planet as soon as possible. Stroll around, here are a few spots you should definitely check out. There is an interesting old building right next to the big market place - you will probably need a special key to open the doors there... Around the place there are lots of other buildings, the house of the mayor with a huge amount of old files and many hidden treasure boxes, a little hut where they used to sell Galaxy Coke and a little chapel which kind of looks a bit intimidating.

You are situated in the centre of Lihue. You can head into each direction. The volcano is in north east from where you are at the moment. Every other part of Lihue is somewhere around you. Go and explore a little.

>Error exploring east from Lihue.

>e
The Old Chapel
Tons of figures you know from the bible and other holy papers are exhibited here. No one knows why, maybe they explain the gold rush where people from all over the galaxy flocked to this particular place. Some seemed to be very religious and brought some belongings along with them. The ceiling is a little bit demolished but the chapel as a whole doesn't look too bad actually. It's quite an intimidating place because there is not a soul in sight and the pictures on the wall have angry faces everywhere. In the corner where the confessional box is there is an arsenal of a few old weapons including swords and a dagger. The dagger might help you as it has a volcano engraved. The coffin under the altar contains something you will need for sure. Somewhere in the little Village there is a hidden key for that particular coffin. Go search for that key and come back later.

In the south you'll find the house where the Mayor used to politically tie the ropes for Lihue. If you head north you will walk on another long trail in order to reach the highest Volcano in the area. In the west, there is the center of Lihue.

You can see a coffin (closed) here.

>Error exploring west from The Old Chapel.

>open coffin
It seems to be locked.

>Error exploring west from The Old Chapel.

>unlock coffin with old_key
You unlock the coffin.

>Error exploring west from The Old Chapel.

>open coffin
Wow, a black mysterious key with some letters on it saying LAVA KEY. Take it. 

 You can only take it if you type in take lavakey.

>Error exploring west from The Old Chapel.

>take key
You can't see any such thing.

>Error exploring west from The Old Chapel.

>take lavakey
(putting the land mine into the backpack to make room)
Taken.

>Error exploring west from The Old Chapel.

>n
Na Pali Trail
Na Pali is Geysirian and means The Long Walk. You will walk for a while I guess. But that's not a problem for you as you are a tough and strong dude, aren't you Axesto?

You can either head south and stay on the trail to reach the little ghost town Lihue, head north to reach the highest volcano, the Haiku Volcano or head west in order to go back to the Landing Zone to try another way into the heart of the planet.

>n
Haiku Volcano
Very high, very bad sight and dangerous drop-offs characterize the Haiku Volcano. Many centuries ago this volcano area has been formed and Haiku Volcano is the highest one. Imagine the power that has been set free in that eruption. This must have been a massive spectacke. Ah, yeah and you can climb that infamous volcano - if it's not too cloudy you will have a great view over... well... wasteland. You know it, only deserted landscape without much more. But anyway, standing on top something is cool isn't it? Decide for yourself if it's worth the hassle. I heard a rumour that a mysterious cave is underneath this particular volcano...

Your options here are: Go west to walk the Pe'ahi trail back to the little village Lihue and therefore direction Landing Zone. You can also east on the Na Pali trail to reach the other end of Lihue. Last but not least, as you might know already if you're able to read between the lines you can also step down here. Try it, going down doesn't hurt. Only sometimes.

You can see lava keyhole here.

>d
(first opening lava keyhole)
It seems to be locked.

>d
(first opening lava keyhole)
It seems to be locked.

>unlock lava keyhole with lavakey
You unlock lava keyhole.

>d
(first opening lava keyhole)

Paia Cave
You made it. Just a few more steps and you will be ready to leave this lifeless and vast planet. All you have to do is find the point on your underwater map where you can use one of your tools (if you found it) in order to make the volcanoes and geysirs go to sleep.

You can either head UP again, if you need to search for a tool that fits into the heart of the volcano. There is also an option to go west - Paia Cave and Pu'ulau Cave are connected through the underwater cave system.

You can see lava keyhole here.

>w
Pu'ulau Cave
The infamous Pu'ulau Cave - no one has ever been here before. Many have had the underwater map, but congratulations again, you are the first one to ever connect the dots and find the right way into this little and very complex underwater system. Do you see the light at the end of the tunnel? This is the heart of the volcano. If you reach it before a fire storm from Paia Cave coes - you will destroy every volcano on this planet and you can head back to your spaceship to leave the extincted area.

Two options: Go east in order to head a volcanic cave called Paia Cave. You'll find a connection to another part of the planet there.

Climb UP to exit the cave system through the geysir entry. Head west to reach the heart of the whole Geysiria system.

You can see a waterdagger here.

>w
The Heart of Geysiria
This is your last step to finally stop all the ash clouds and the constant lava flow above ground. The underwater system map led you here - you should make use of your one and only tool that will fit into the little heart that is at the end of this tiny corridor. May Geysiria rest in peace.

Examine the water dagger hole in order to see if there are hidden dangers or something that will prevent you from putting the waterdagger into the probably fitting hole. You also have the option to walk back (west).

You can see a water dagger hole (closed) here.

>e
Pu'ulau Cave
The infamous Pu'ulau Cave - no one has ever been here before. Many have had the underwater map, but congratulations again, you are the first one to ever connect the dots and find the right way into this little and very complex underwater system. Do you see the light at the end of the tunnel? This is the heart of the volcano. If you reach it before a fire storm from Paia Cave coes - you will destroy every volcano on this planet and you can head back to your spaceship to leave the extincted area.

Two options: Go east in order to head a volcanic cave called Paia Cave. You'll find a connection to another part of the planet there.

Climb UP to exit the cave system through the geysir entry. Head west to reach the heart of the whole Geysiria system.

You can see a waterdagger here.

>take waterdagger
(putting the picklock into the backpack to make room)
Taken.

>w
The Heart of Geysiria
This is your last step to finally stop all the ash clouds and the constant lava flow above ground. The underwater system map led you here - you should make use of your one and only tool that will fit into the little heart that is at the end of this tiny corridor. May Geysiria rest in peace.

Examine the water dagger hole in order to see if there are hidden dangers or something that will prevent you from putting the waterdagger into the probably fitting hole. You also have the option to walk back (west).

You can see a water dagger hole (closed) here.

>x dagegr
You can't see any such thing.

>x dagger
You see nothing special about the water dagger hole.

>x water dagger
You see nothing special about the water dagger hole.

>put water dagger into hol
You can't see any such thing.

>put water dagger into hole
(first taking the water dagger hole)
That's fixed in place.

>open hole
It seems to be locked.

>unlock hole
What do you want to unlock the water dagger hole with?

>unlock hole with dagger
(first taking the water dagger hole)
That's fixed in place.

>unlock water dagger hole with water dagger
(first taking the water dagger hole)
That's fixed in place.

* * *

>take kaldríss
Spaceship Bridge
The place where all the magic happens. Well, it used to be at least - during the impact most of the important equpiment, including the communication systems, must have been fried and doesn't seem to work anymore.

There's only a single flickering light inside the command panel.

What could this mean? I should probably open the command panel and take a look. I could also go south and check the storage of the spaceship first.

You can see a command panel (closed) here.