Welcome to your journey, Axesto! Take a seat, sit back and enjoy. Hier fehlt noch die Geschichte, warum Axesto seinen Heimatplaneten Fidatis verlassen hat. Der erste Planeten, den du ansteuerst, nennt sich Sitis. Der einzige Planeten, den du von deiner Heimat aus als goldbraun leuchtenden Stern wahnehmen konntest. Du hast dich schon immer gefragt, wer und was dort lebt. Also los gehts!

On the Lookout
An Interactive Fiction by Daniel, Tim, Franziska, Kevin, Tobias
Release 1 / Serial number 170803 / Inform 7 build 6M62 (I6/v6.33 lib 6/12N) SD

Your arrival point. The Flat Rock
You arrive on a planet called Sitis. You think the landing went great but as you leave your spaceship, you realise that two of your three water container broke down. Without minimum one new watertank you can not continue your journey. Far away in the east you recognise some kind of different rooftops. Maybe someones living there who could help you?

You can see Teleportation Stone - Sitis, Teleportation Stone - Gaisetto, Teleportation Stone - Geysiria, Teleportation Stone - Frizza and Teleportation Stone - Kaldríss here.

>helper
---
This is the help section, you will get a list of essential commands that you can use in the game.

Basic Commands

look - shows you the room you are currently in
 e(x)amine (something)- get information about a thing or a person (if no object or person is specified, something will be examined automatically, if it's the only thing in the room
 take (something) - take and carry something
 (i)nventory - show what you are carrying

(e)ast - go east
 (w)est - go west
 (s)outh - go south
 (n)orth - go north

save - produce a local save file on your computer
 restore - load a local save file
 quit - quit the game

Sitis

End of help section
---

>e
The Wide Desert
You've reached the Desert of Sitis. It gives you two things: First, an impression of what whole Sitis looks like - sandy, dry, with some deep stone canyons and huge rocks afar. But although this planet does not seem to be a place to life, the Desert also gives you the chance to discern that you are not alone. There IS life! When you look north, directly in front of you is a long corrugated iron bridge, guiding over one of those ravines. You can not access the bridge, it is blocked with a barbed wire fence, but straight ahead, at the end you see a majestic sandstone palace. In the bridge's middel, a wooden ladder leads to an enormous square block in the east. Likewise it is built out of stone and gives a somber impression. If you look east from the point you are standing at right now, you see the kind of a rock mine. In the south you recognise a lot of small white houses surrounded by a rampart. It seems like people are living here.

* * *

>take gaisetto
Landingzone
You are standing an a clearing. South of you is your spaceship right in front of a cliff. All the other directions you are surrounded by the deep green of the jungle.

* * *

>exit
But you aren't in anything at the moment.

* * *

>take kaldríss
Spaceship Bridge
The place where all the magic happens. Well, it used to be at least - during the impact most of the important equpiment, including the communication systems, must have been fried and doesn't seem to work anymore.

There's only a single flickering light inside the command panel.

What could this mean? I should probably open the command panel and take a look. I could also go south and check the storage of the spaceship first.

You can see a command panel (closed) here.

>take frizza
Landing Zone
You step out of your ship onto a small square in the middle of nowhere. Your ship's dead and so is the computer. It seems like you ought to explore the environment. You remeber having seen civilization-like shapes to the south and to the north. To the east  there is a huge mountain, to the west there seems to be a Flux. You think you have seen something, or someone, moving on the mountain to the east, there might be people there.

You can see a Discharged Spaceship (in which is a Power Unit (empty)) here.

* * *

>take frizza
Landing Zone
You step out of your ship onto a small square in the middle of nowhere. Your ship's dead and so is the computer. It seems like you ought to explore the environment. You think you have seen something, or someone, moving on the mountain to the east, there might be people there. You also remeber having seen civilization-like shapes to the south and to the north. To the east  there is a huge mountain, to the west there seems to be a Flux.

You can see a Discharged Spaceship (in which is a Power Unit (empty)) here.

>w
Flux before the Gate
A viscous and turbulent current of blue fluid cuts through the plane. You need to screen your eyes from the radiating light to not become blinded. Even at this distance you feel the Flux presence in your body, as if your atoms were spinning three times their normal pace. A huge rock loosely stands at the current's shores.

You can go east, back to the Landing Zone, and south, to the Scoop.

You can see an Unregulated Flux Current and a Monolithic Rock here.

>e
Landing Zone
Your crash site. You can go in all directions. You think you have seen something, or someone, moving on the mountain to the east, there might be people there. You also remeber having seen civilization-like shapes to the south and to the north. To the east  there is a huge mountain, to the west there seems to be a Flux.

You can see Teleportation Stone - Kaldríss, Teleportation Stone - Frizza, Teleportation Stone - Geysiria, Teleportation Stone - Gaisetto, Teleportation Stone - Sitis and a Discharged Spaceship (in which is a Power Unit (empty)) here.

>w
Flux before the Gate
The main Flux current of the region. A huge rock loosely stands at its shores.

You can go east, back to the Landing Zone, and south, to the Scoop.

You can see an Unregulated Flux Current and a Monolithic Rock here.

* * *

>e
Landing Zone
Your crash site. You can go in all directions. You think you have seen something, or someone, moving on the mountain to the east, there might be people there. You also remeber having seen civilization-like shapes to the south and to the north. To the east  there is a huge mountain, to the west there seems to be a Flux.

You can see Teleportation Stone - Kaldríss, Teleportation Stone - Frizza, Teleportation Stone - Geysiria, Teleportation Stone - Gaisetto, Teleportation Stone - Sitis and a Discharged Spaceship (in which is a Power Unit (empty)) here.

>n
Wasteland
A pitiful piece of land. Black sand, red rocks and some sickish looking plants. If you are not looking for something particular there is no need to linger.

You can go west, to the Flux Gate, north, to the edge of the city, and south, back to the Landing Zone.

>n
Verge of the Bloo City
An averagely sized city extends in front of you. Its cityscape is dominated by an enormous building in the rear part, not resembling any architecture that you have ever seen. Halfway to it there seems to be some sort of city center. The city is surrounded by a foreign sort of fencing, with a gate not far form you.

You can go west, to the Flux beyond the Gate, north, into the city, and south, to the Wasteland.

>w
Flux beyond the Gate
A smooth current of the Flux, it flows like a gentle river. Even from the distance you feel the pure energy flooding your body. It appears to have a slightly different viscosity than the other Fluxes, maybe it has something to do with the Flux Gate arking above the Flux in the south.

You can go east, back to the Wasteland.

You can see a Regulated Flux Current here.

>e
Verge of the Bloo City
The pathway into the alien city. 

You can go west, to the Flux beyond the Gate, north, into the city, and south, to the Wasteland.

>s
Wasteland
One of the dreary planes in the region.

You can go west, to the Flux Gate, north, to the edge of the city, and south, back to the Landing Zone.

>n
Verge of the Bloo City
The pathway into the alien city. 

You can go west, to the Flux beyond the Gate, north, into the city, and south, to the Wasteland.

>w
Flux beyond the Gate
A branch of the Flux, it emerges from under the Flux Gate to the south, appearing soothed and even.

You can go east, back to the Wasteland.

You can see a Regulated Flux Current here.

>e
Verge of the Bloo City
The pathway into the alien city. 

You can go west, to the Flux beyond the Gate, north, into the city, and south, to the Wasteland.

* * *

>s
Wasteland
One of the dreary planes in the region.

You can go west, to the Flux Gate, north, to the edge of the city, and south, back to the Landing Zone.

>w
Flux Gate
An archlike structure stands out against the vastness of the planes. As you approach you become aware of some figures in front of the structure. Strangely, it looks like they were glowing bluishly. At second glance they seem hardly human, you don't know how they will react to your appearance. 

You can go east, back to the Wasteland.

>e
Wasteland
One of the dreary planes in the region.

You can go west, to the Flux Gate, north, to the edge of the city, and south, back to the Landing Zone.

>w
Flux Gate
A gate of some sort, guarded.

You can go east, back to the Wasteland.

>e
Wasteland
One of the dreary planes in the region.

You can go west, to the Flux Gate, north, to the edge of the city, and south, back to the Landing Zone.

>s
Landing Zone
Your crash site. You can go in all directions. You think you have seen something, or someone, moving on the mountain to the east, there might be people there. You also remeber having seen civilization-like shapes to the south and to the north. To the east  there is a huge mountain, to the west there seems to be a Flux.

You can see Teleportation Stone - Kaldríss, Teleportation Stone - Frizza, Teleportation Stone - Geysiria, Teleportation Stone - Gaisetto, Teleportation Stone - Sitis and a Discharged Spaceship (in which is a Power Unit (empty)) here.

>w
Flux before the Gate
The main Flux current of the region, wild and agitated at this point. A huge rock loosely stands at its shores.

You can go east, back to the Landing Zone, and south, to the Scoop.

You can see an Unregulated Flux Current and a Monolithic Rock here.

>e
Landing Zone
Your crash site. You can go in all directions. You think you have seen something, or someone, moving on the mountain to the east, there might be people there. You also remeber having seen civilization-like shapes to the south and to the north. To the east  there is a huge mountain, to the west there seems to be a Flux.

You can see Teleportation Stone - Kaldríss, Teleportation Stone - Frizza, Teleportation Stone - Geysiria, Teleportation Stone - Gaisetto, Teleportation Stone - Sitis and a Discharged Spaceship (in which is a Power Unit (empty)) here.

>n
Wasteland
One of the dreary planes in the region.

You can go west, to the Flux Gate, north, to the edge of the city, and south, back to the Landing Zone.

>w
Flux Gate
A gate of some sort, guarded.

You can go east, back to the Wasteland.

>ener gate
That's not a verb I recognise.

>enter gate
You can't see any such thing.

>e
Wasteland
One of the dreary planes in the region.

You can go west, to the Flux Gate, north, to the edge of the city, and south, back to the Landing Zone.

>n
Verge of the Bloo City
The pathway into the alien city. 

You can go west, to the Flux beyond the Gate, north, into the city, and south, to the Wasteland.

* * *

>s
Wasteland
One of the dreary planes in the region.

You can go west, to the Flux Gate, north, to the edge of the city, and south, back to the Landing Zone.

>s
Landing Zone
Your crash site. You can go in all directions. You think you have seen something, or someone, moving on the mountain to the east, there might be people there. You also remeber having seen civilization-like shapes to the south and to the north. To the east  there is a huge mountain, to the west there seems to be a Flux.

You can see Teleportation Stone - Kaldríss, Teleportation Stone - Frizza, Teleportation Stone - Geysiria, Teleportation Stone - Gaisetto, Teleportation Stone - Sitis and a Discharged Spaceship (in which is a Power Unit (empty)) here.

* * *

>w
Flux Gate
A gate of some sort, guarded.

You can go east, back to the Wasteland.

>ask Dunia about cloak
You can't see any such thing.

>ask Dunia about help
You can't see any such thing.

>look
Flux Gate
A gate of some sort, guarded.

You can go east, back to the Wasteland.

>e
Wasteland
One of the dreary planes in the region.

You can go west, to the Flux Gate, north, to the edge of the city, and south, back to the Landing Zone.

* * *

>s
Landing Zone
Your crash site. You can go in all directions. You think you have seen something, or someone, moving on the mountain to the east, there might be people there. You also remeber having seen civilization-like shapes to the south and to the north. To the east  there is a huge mountain, to the west there seems to be a Flux.

You can see Teleportation Stone - Kaldríss, Teleportation Stone - Frizza, Teleportation Stone - Geysiria, Teleportation Stone - Gaisetto, Teleportation Stone - Sitis and a Discharged Spaceship (in which is a Power Unit (empty)) here.

>e
Ascent
The mountains are composed of stone in various shades of red and reach far to the sky. In between the cliffs and sheers you see a narrow path winding up, at the beginning of which are small pillars - one marked with an insignia.. There is no clue on where it might lead, but you could find out.

You can also go west, back to the Landing Zone

* * *

>u
You have the feeling of being watched. You wouldn't want to climb the cliffs if someone is around. Maybe looking around would reveal whoever is hiding.

>x
(the backpack)
The backpack is empty.

>x dunia
A lean but athletic figure, wrapped by several layers of what looks like tough leather. In a small gap of her hood you can see glinting eyes that reveal a sharp mind. You could ask her about everything surrounding you: the Flux, the Duju, the City ...

You are painfully near to trespass holy ground, stranger. I would advise against it. Who are you, anyway? You don't look like a Techie. Tell me your name.

>answer Axesto
(to Dunia)
What a strange name. It doesn't matter anyway - there's only one thing I need to know: are you on the side of the Duju or of the Techies?

>answer Duju
(to Dunia)
Well then, that's not a bad way to start. Thinking about it - an outsider might be what we need. I'll introduce you to someone, and that is not an invitation.

 With seemingly little effort she climbs down the cliffs to your level, before insistently inviting you to come with her.
 Both of you walk through the scraggy landscape, her leading the way with distinct commands. Slowly you approach an archlike structure, close to one branch of the Flux.

Flux Gate

As you get nearer you perceive a couple of bulky shapes, guarding the entrance to the structure. Some hundred meters in front of the entrance your companion turns to you.Try not to look too provoking.

You know why while passing the guards: each and every one of them gazes at you. In consideration of the thick armour plates, the rather oversized guns and their radiating blue glow you refrain from making any quick motions.
Inside you find yourself in the midst of a small-sized hall, that doesn't appear to justify any of the expenditure you just encountered. In the back you spot an opening and a staircase, leading downwards. To the left there is a full board of controls and two figures unhastily operating them. You can't look around any more, as you are approached quickly by an impressively sized Duju, already bellowing words in your direction with a booming voice.

Dunia! Who is this? Explain yourself!

A guest of sorts. He stumbled about the Ascent when I found him. I don't think he's a Techie, at least he has slightly better manners and he keeps his voice down to a sensible level when talking. Besides, I thought about his use in regard to certain issues, due to his undujulike appearance.

Both eyeball you thoroughly for what seems like hours. Eventually, the massive Duju makes a quick motion towards Dunia, indicating her to follow him. He shoots a last glance at you, accompanied by a warning.

Don't let yourself be found sniffing around somewhere, it would not contribute to your wellbeing.

They march off, disappearing into the opening at the end of the hall. You are not guarded, it seems like you could look around. Of course you could also do as you were told and wait.

>wait
You stand still where you were left. Time passes. However, that seems to be the only thing to change. You ought to wait a little longer before Dunia and Du'un return.

* * *

>wait
You pass the time looking closer at your surroundings, but you can't interpret all too much from the metallic alien structures. The architecture somewhat reminds you of the spiritual buildings on your home planet, as for the arching walls and the high ceiling. The only thing you hear is the distant, lamish flow of the Flux and the dull sounds of the two operators at the console. You ought to wait a little longer before Dunia and Du'un return.

>wait
Finally you see the two Duju returning from the opening. As they approach, the big one actually looks amazed by your decent behaviour.

It seems like you did as you were told. Maybe you don't have no ill intent after all. Indeed - that is exactly what we're going to find out, if you're willing. But you see, we don't want to force anything on you, you are free to leave. But if you are interested in helping us, we would be glad.

He hands you something that distantly reminds you of a fishing net, only is this one almost ridiculously overengineered. You must have a rather puzzled look to your face, as Du'un starts to explain soon after. 

That is a Flux Extractor, the Techies call them "Scoops". It is used to extract small portions of the Flux and isolate it for examination. If you want to help us out, showing us that you have no evil intent in the process, go and extract two samples of the Flux: one from the current before it passes through this gate, from the Flux before the Gate, and one after it has done so, from the Flux beyond the Gate. I am sure you will find the proper locations for this purpose yourself. When you are done or have any questions, return here to the Flux Gate, Dunia will be to your assistance. You can always ask her about the Extraction, or about help in general for that matter.

You receive a Flux Extractor.

With that, Du'un goes off, quickly descending the stairs at the back of the hall. You are left with a vague task and Dunia, who doesn't look very pleased.

To your assitance, eh? Well, better than climbing that awful piece of a mountain, I suppose. Alright, if you need anything or want to ask me anything: I stay here at the Flux Gate. Come back to me whenever you want.

>ask Dunia about cloak
There is no reply.

>ask Dunia about extraction
You heard the old man. Go and extract two samples of the Flux: one from the current before it passes through this gate, at the Flux before the Gate, and one after it has done so, at the Flux beyond the Gate. You will need to approach  the Currents before being able to extract something. Return to me if you have the two samples and ask me about the Flux Essences.

>ask Dunia about help
She giggles a bit.

It is simple, you will see when you get to the Flux. Just dip it in.

She shows a devilish grin. 

Oh, but there's something I can help you with.

Suddenly Dunia grasps a corner of her leathery clothing and, with one swoosh, unwraps it from her body. Underneath, a sinewy, bluish body comes to appearance.

Here, take this, it will prevent the Flux from disintegrating you all too fast, when you wear it.

The devilish grin emerges again.

And stop staring.

You receive a Sinkan Cloak.

>wear cloak
You put on the Sinkan Cloak.

>e
Wasteland
One of the dreary planes in the region.

You can go west, to the Flux Gate, north, to the edge of the city, and south, back to the Landing Zone.

* * *

>w
Flux beyond the Gate
A branch of the Flux, it emerges from under the Flux Gate to the south, appearing soothed and even.

You can go east, back to the Wasteland.

You can see a Regulated Flux Current here.

>approach current
Very cautiously you approach the Flux. While coming nearer, each step feels like pumping pure electrictiy into the ground. Your whole body swings in an unknown rhythm. You are only a few steps away now. The Flux flowing lamishly as ever, blistering, throwing arcs of bluish vapor. You feel your atoms slowly leaving their place, starting to rearrange. You take one step after the other, always expecting that your legs will come apart with the next one. Finally, you reach the pedestal. As you crawl onto it, you feel your mind dissolving, your synapses strewing about. You are becoming the Flux. You should extract the sample as fast as possible if you want to survive this.

>extract
(sample from the Regulated Flux Current)
You thrust your arm over the ledge, despairingly clasping the Flux Extractor, not knowing whether your arm will dematerialize in an instant. The Extractor extends automatically and dips its head into the glowing liquid. You think to hear a beeping sound. It blurs, as your mind dives into the Flux, becomes energy. You perceive magnetic fields, penetrated by some foreign control. You feel the stream, the Flux arranging itself, its symbioses with the planet. You feel the life essence of the Duju, feeding from the Flux. And you feel its core, more powerful than any other source you ever knew, burried deep down in the caverns. Still you have a slim link to your body, but it trembles and shakes heavily. Finally, your hear a tedious, enduring beeping sound. The Flux Extractor is finished, it now carries a sample of the Flux. You force yourself to crawl down the pedestal, your hands feeling like they would disintegrate any moment, their contours growing hazy. With each step you take away from the Flux, your mind and body recover their focus. You drag yourself up the shore and up the cliffs, before collapsing on the rocky soil.

You wake up.

You receive a Regulated Flux Essence. You should now look for the Flux before the Gate, were you will need to extract another sample.

>e
Verge of the Bloo City
The pathway into the alien city. 

You can go west, to the Flux beyond the Gate, north, into the city, and south, to the Wasteland.

* * *

>s
Wasteland
One of the dreary planes in the region.

You can go west, to the Flux Gate, north, to the edge of the city, and south, back to the Landing Zone.

>s
Wasteland
One of the dreary planes in the region.

You can go west, to the Flux Gate, north, to the edge of the city, and south, back to the Landing Zone.

Landing Zone
Your crash site. You can go in all directions. You remeber having seen civilization-like shapes to the south and to the north. To the east  there is a huge mountain, to the west there seems to be a Flux. 

You can see Teleportation Stone - Kaldríss, Teleportation Stone - Frizza, Teleportation Stone - Geysiria, Teleportation Stone - Gaisetto, Teleportation Stone - Sitis and a Discharged Spaceship (in which is a Power Unit (empty)) here.

>w
Flux before the Gate
The main Flux current of the region, wild and agitated at this point. A huge rock loosely stands at its shores.

You can go east, back to the Landing Zone, and south, to the Scoop.

You can see an Unregulated Flux Current and a Monolithic Rock here.

>push rock
Even if it stands loose, you can't shove it with only your muscles.

>x rock
A huge, slender rock looms at the shore of the Flux. It would make a good land to the Flux. It doesn't seem to stand all too stable, if you could only push it over with something ...

>e
Flux before the Gate
The main Flux current of the region, wild and agitated at this point. A huge rock loosely stands at its shores.

You can go east, back to the Landing Zone, and south, to the Scoop.

You can see an Unregulated Flux Current and a Monolithic Rock here.

Landing Zone
Your crash site. You can go in all directions. You remeber having seen civilization-like shapes to the south and to the north. To the east  there is a huge mountain, to the west there seems to be a Flux. 

You can see Teleportation Stone - Kaldríss, Teleportation Stone - Frizza, Teleportation Stone - Geysiria, Teleportation Stone - Gaisetto, Teleportation Stone - Sitis and a Discharged Spaceship (in which is a Power Unit (empty)) here.

>n
Wasteland
One of the dreary planes in the region.

You can go west, to the Flux Gate, north, to the edge of the city, and south, back to the Landing Zone.

>w
Flux Gate
A gate of some sort, guarded.

You can go east, back to the Wasteland.

You can see Dunia, a Descent, a console, a weapon's rack (on which is a gun), Duju Operator 1 and Duju Operator 2 here.

>ask Dunia about rock
Ah, I see, you look for a way to get down to the current. Well, the gun is not what will help you, even if I gave it to you, which I won't, you still needed to fire it, which you can't. So erase that thought. However ... what might help you ... wait a moment.

 Dunia turns to the rack, which the gun lies on, and resolutely approaches it. With a few precise movements she breaks loose one of the bars framing the rack, accompanied by a bright clang. Even the guards take a short glance, before respectfully turning to the entrance again. Triumphantly, Dunia returns to you and hands you the bar with a smirk. 

Congratulations, you are now the owner of a convenient lifting tool.

You receive a Miserable Lever.

>e
Wasteland
One of the dreary planes in the region.

You can go west, to the Flux Gate, north, to the edge of the city, and south, back to the Landing Zone.

>s
Wasteland
One of the dreary planes in the region.

You can go west, to the Flux Gate, north, to the edge of the city, and south, back to the Landing Zone.

Landing Zone
Your crash site. You can go in all directions. You remeber having seen civilization-like shapes to the south and to the north. To the east  there is a huge mountain, to the west there seems to be a Flux. 

You can see Teleportation Stone - Kaldríss, Teleportation Stone - Frizza, Teleportation Stone - Geysiria, Teleportation Stone - Gaisetto, Teleportation Stone - Sitis and a Discharged Spaceship (in which is a Power Unit (empty)) here.

* * *

>w
Flux before the Gate
The main Flux current of the region, wild and agitated at this point. A huge rock loosely stands at its shores.

You can go east, back to the Landing Zone, and south, to the Scoop.

You can see an Unregulated Flux Current and a Monolithic Rock here.

>push rock
You thrust the bar into the soil under the rock and start levering. Even with the amplified force you need your whole body to move the rock. Finally, it staggers, and with a last effort you make it topple over. The rock slowly tilts and then continues, with a mighty rumble, to drop into the flux, sending huge waves to both sides. You now have a descent into the Flux, you can try to approach it. However, your already miserable Lever now is little more than a bent piece of metal, you leave it on the ground.

>approach current
With little effort you climb down your newfound ramp. As you come closer to the Flux, you feel your body resonating, feeling as if it would prefer to dissolve. Quickly, you extend the Extractor into the Flux and try to keep your fluttering mind together, while hearing the beeping sound. Shorty, you have visions of a brute Duju, clad in plates of thick metal, thorns protruding from the shoulders. Then a lean figure, wrapped in a long black robe, operating some sort of complex device in front of what seems to you like an altar. A penetrating beeping draws you out of your sight. The Extractor is finished. You scramble up to the shore and quickly bring some distance between you and the Flux, your mind and body slowly regaining their place. 

You receive an Unregulated Flux Essence.

You have both essences. You should return to Dunia and ask her about the Flux Essences.

* * *

>w
Flux before the Gate
A viscous and turbulent current of blue fluid cuts through the plane. You need to screen your eyes from the radiating light to not become blinded. Even at this distance you feel the Flux presence in your body, as if your atoms were spinning three times their normal pace. A huge rock loosely stands at the current's shores.

You can go east, back to the Landing Zone, and south, to the Scoop.

You can see an Unregulated Flux Current and a Monolithic Rock here.

>x rock
A huge, slender rock looms at the shore of the Flux. It would make a good land to the Flux. It doesn't seem to stand all too stable, if you could only push it over with something ...

>s
Scoop (Settler's Base)
You see a part of the Flux winding through a fjord deep down. Above your level there are metal constructions, thrust into the rock, from where little transportation devices start to the blue current at the valley's bottom, each manned with two humanlike figures. Near the bridgelike scaffold (you think it may be the only way across the gap) you notice some cabins, tightly hugging the cliffs. It seems you could approach the nearest one.

You can go west , to the Control Tower, north, to the Flux before the Gate, and east, to the Wasteland.

You can see a Cabin (empty) here.

>approach cabin
You scramble over the ghastly landscape, keeping the ravine's edge to a good distance. You get an even better view of the structures that span the width of the gorge, you are now certain that there is mining equipment and transportation units, some manned and some apparently controlled remotely. You approach the cabin, saving a couple of steps in distance, and try to glance into the inside of the cabin. Someone sits there at a metal desk, wearing a hardhat and sunglasses, between ridiculous heaps of papers and files. In his mouth there is an oblong roll, glowing blue, and on one of the inside wall hangs an oversized metal suit, equipped with all kind of complex-looking gear. As you eyeball the scene, the man suddenly turns his head and straigthly spots you through his shaded glasses. He stands up opens a window, pointing in your direction. You see a broad smile stamped into his face.

Oi, mate! What ya doin" all by yaself out there? Ya ain't have no mischief in mind, do ya? Don't look like one of those blue Duju folk. What's ya name, mate?

The thick accent washes over you. Momentarily, you believe you smelled grilled meat ... you abandon the thought.